有没有单依纯的音乐	com.sqq.hy.music
有没有周杰轮的音乐	com.sqq.hy.music
有没有不一样的音乐	com.sqq.hy.music
立刻给我听一下乔艳艳的北上广的我们	com.sqq.hy.music
刀郎的专辑刀郎	com.sqq.hy.music
给我播放一下要不要买菜的下山	com.sqq.hy.music
有没有有地方特色的音乐	com.sqq.hy.music
请把王贰浪像鱼循环播放	com.sqq.hy.music
播一下王菲因为爱情	com.sqq.hy.music
播放张杰翻唱的山海	com.sqq.hy.music
播放张杰翻唱的歌	com.sqq.hy.music
因为爱情播一下	com.sqq.hy.music
王菲的歌播一下	com.sqq.hy.music
给我播放一下要不要买菜写的歌	com.sqq.hy.music
给我播放一下要不要买菜唱的歌	com.sqq.hy.music
演唱一首歌	com.sqq.hy.music
刀郎的个单曲循环	com.sqq.hy.music
搞一首杨宗纬的一次就好	com.sqq.hy.music
搞一首青花瓷听听	com.sqq.hy.music
牛奶咖啡的歌放来听听吧	com.sqq.hy.music
明天你好放来听听吧	com.sqq.hy.music
循环播放下剑三群像江湖意	com.sqq.hy.music
杨真鹏口是心非播放给我听	com.sqq.hy.music
播放校花的贴身高手	com.sqq.hy.iptv
播放一下轮回的捉弄	com.sqq.hy.iptv
播放卡巴机器人	com.sqq.hy.iptv
播放一下天气好的话我会去找你	com.sqq.hy.iptv
播放今日最新闻	com.sqq.hy.iptv
播放一下童程童美乐高创意启蒙课程	com.sqq.hy.iptv
播放田小艾学汉字蔬菜识字	com.sqq.hy.iptv
播放一下武汉我的战疫日记第2季	com.sqq.hy.iptv
播放删除历史	com.sqq.hy.iptv
播放一下边境归途	com.sqq.hy.iptv
播放假偶天成	com.sqq.hy.iptv
播放一下我的妹妹	com.sqq.hy.iptv
播放博物志精彩片段	com.sqq.hy.iptv
播放一下乐高ev3智能机器人编程课程	com.sqq.hy.iptv
播放没有输给美国的男人混蛋首相吉田茂	com.sqq.hy.iptv
播放一下人妖阿發痴人三部曲13	com.sqq.hy.iptv
播放公主童话故事会魔法的公主们	com.sqq.hy.iptv
播放一下幼儿美语系列	com.sqq.hy.iptv
播放少儿体能训练课	com.sqq.hy.iptv
播放一下乐高创意启蒙课程	com.sqq.hy.iptv
播放博物志	com.sqq.hy.iptv
播放一下公主童话故事	com.sqq.hy.iptv
播放德云社张鹤伦相声专场天津站二零一九	com.sqq.hy.iptv
开始播放德云社张鹤伦相声专场天津站2019	com.sqq.hy.iptv
播放一下请回答王牌第二季	com.sqq.hy.iptv
开始播放请回答王牌第2季	com.sqq.hy.iptv
播放哈利法克斯最后的探戈五	com.sqq.hy.iptv
开始播放哈利法克斯最后的探戈第五季	com.sqq.hy.iptv
播放一下中国好声音二零一九精彩片段	com.sqq.hy.iptv
开始播放中国好声音2019精彩片段	com.sqq.hy.iptv
播放小鬼当家二零二零	com.sqq.hy.iptv
开始播放小鬼当家2020	com.sqq.hy.iptv
播放一下武汉我的战疫日记第二季	com.sqq.hy.iptv
开始播放武汉我的战疫日记第2季	com.sqq.hy.iptv
播放乐高e v3智能机器人编程课程	com.sqq.hy.iptv
开始播放乐高ev3智能机器人编程课程	com.sqq.hy.iptv
播放一下人妖阿發痴人三部曲三分之一	com.sqq.hy.iptv
开始播放人妖阿發痴人三部曲13	com.sqq.hy.iptv
播放德云社张鹤伦相声专场天津站	com.sqq.hy.iptv
播放一下我的动作书	com.sqq.hy.iptv
播放哈利法克斯最后的探戈	com.sqq.hy.iptv
播放一下乐高创意启蒙课	com.sqq.hy.iptv
播放我的战疫日记第二季	com.sqq.hy.iptv
播放一下会魔法的公主们	com.sqq.hy.iptv
播放请回答王牌二	com.sqq.hy.iptv
开始播放请回答王牌第2季	com.sqq.hy.iptv
播放一下乐高e v三智能机器人编程课程	com.sqq.hy.iptv
开始播放乐高ev3智能机器人编程课程	com.sqq.hy.iptv
播放人妖阿發痴人三部曲	com.sqq.hy.iptv
开始播放人妖阿發痴人三部曲13	com.sqq.hy.iptv
播放一下请回答王牌	com.sqq.hy.iptv
播放我的战疫日记二	com.sqq.hy.iptv
播放一下智能机器人编程课程	com.sqq.hy.iptv
播放人妖阿發痴	com.sqq.hy.iptv
播放一下辣妈学院2020	com.sqq.hy.iptv
播放之江汇教育广场高中三年级数学自主学习	com.sqq.hy.iptv
我想听一个东北立堂儿	com.sqq.audiocontent
汽油生活听一个吧	com.sqq.audiocontent
山村有喜事来一个吧	com.sqq.audiocontent
刑侦进行时放一下吧	com.sqq.audiocontent
劳烦给我放一个冲天香阵	com.sqq.audiocontent
继续播放小说社会哥风流生活	com.sqq.audiocontent
农女有喜夫君来种田给我播一下	com.sqq.audiocontent
我要听林正英的玄门道徒	com.sqq.audiocontent
给孩子的窗边的小豆豆听听看	com.sqq.audiocontent
推荐下谢宝平家书抚摸年轮	com.sqq.audiocontent
刘琳长夜难明的无证之罪很有名很想听	com.sqq.audiocontent
刘兰芳话说泰山	com.sqq.audiocontent
刘兰芳马年说马	com.sqq.audiocontent
我的媳妇儿是阿飘立刻给我播放	com.sqq.audiocontent
超级捉鬼道长你给我播放一下	com.sqq.audiocontent
我想听一下太乙阴阳	com.sqq.audiocontent
给放一下青岚志怪	com.sqq.audiocontent
招阴马上播放	com.sqq.audiocontent
我是女先生现在立刻播放	com.sqq.audiocontent
一封遗书立马给我放一下	com.sqq.audiocontent
立刻播放一个无限追凶专案组	com.sqq.audiocontent
现在给我播放一下烧尸匠	com.sqq.audiocontent
能不能播放一下人尸契约	com.sqq.audiocontent
立刻播放四十九号客栈	com.sqq.audiocontent
播放一下诡医	com.sqq.audiocontent
推荐一下306号秘密	com.sqq.audiocontent
重新播放一下阴阳画师	com.sqq.audiocontent
鬼才开始拍鬼片马上播放一个	com.sqq.audiocontent
给孩子播放一个阴阳医师	com.sqq.audiocontent
播放最后的獒王	com.sqq.audiocontent
立即播放青春期男孩最需要的引导	com.sqq.audiocontent
请为我播放博多舍费尔小狗钱钱	com.sqq.audiocontent
播母爱的羁绊来听听	com.sqq.audiocontent
播放西游记之孙悟空	com.sqq.audiocontent
播一下东北鬼事三十年这个民间恐怖故事	com.sqq.audiocontent
给我来个国家一级播音员版本的金瓶梅	com.sqq.audiocontent
读一下林音无界写的丹海仙尊	com.sqq.audiocontent
我想听听看五亿人次点击量的超级黄金手	com.sqq.audiocontent
雲中锦的余生不负我想听听看	com.sqq.audiocontent
立刻来一个东北奇闻录	com.sqq.audiocontent
罪己者现在放一下	com.sqq.audiocontent
立刻放一下探宝寻踪之西行大漠	com.sqq.audiocontent
放一下医入警门听听	com.sqq.audiocontent
来放一个凶花听听吧	com.sqq.audiocontent
来一首曲子葫芦丝演奏的	com.sqq.hy.music
云朵唱的我的楼兰给我播来听听	com.sqq.hy.music
搜一下歌曲	com.sqq.hy.music
搜歌曲青花瓷	com.sqq.hy.music
搜青花瓷歌曲	com.sqq.hy.music
搜周杰轮的歌曲	com.sqq.hy.music
搜歌曲	com.sqq.hy.music
请播放中国梦之声我们的歌第二季张信哲演唱的为你我受冷风吹	com.sqq.hy.music
立刻单曲循环叶里谪仙	com.sqq.hy.music
播放你唱的虞兮叹	com.sqq.hy.music
来首歌	com.sqq.hy.music
柴三岁的我们终究也成路人了播来听听	com.sqq.hy.music
牛奶咖啡的歌	com.sqq.hy.music
薛之谦的歌来一段	com.sqq.hy.music
薛之谦刚刚好来一段	com.sqq.hy.music
电视剧我的奇妙男友2主题曲	com.sqq.hy.music
来一首葫芦丝新白娘子传奇	com.sqq.hy.music
播放一下影视原声带	com.sqq.hy.music
马上就想听孤城浪子	com.sqq.hy.music
仙剑奇侠传中的逍遥叹很好听放来听听看	com.sqq.hy.music
推荐剑网三的剧情歌	com.sqq.hy.music
2020浙江卫视跨年晚会隔壁老樊演绎的多想在平庸的生活拥抱你播来听听	com.sqq.hy.music
刘惜君原上草电视剧楚乔传楚乔人物曲	com.sqq.hy.music
恭喜发财2020电影唐人街探案3拜年送福曲	com.sqq.hy.music
来一首葫芦丝曲子	com.sqq.hy.music
这首歌很动听麻烦循环播放	com.sqq.hy.music
海派甜心的歌播放一下	com.sqq.hy.music
马上播放亲爱的树洞	com.sqq.hy.music
馒头妞的蛊梦来首听听看	com.sqq.hy.music
我想听听看不才的参商	com.sqq.hy.music
循环播放下剑三群像江湖意	com.sqq.hy.music
风云之雄霸天下的永远永远让我们回顾下吧	com.sqq.hy.music
这首歌让我们回顾下吧	com.sqq.hy.music
播放一下王靖雯不胖	com.sqq.hy.music
可不可以播放曲比阿且别知己	com.sqq.hy.music
现在立刻给我来一首范茹的生而为人	com.sqq.hy.music
帮我播放刘德华的暗里着迷	com.sqq.hy.music
现在想要听一下苏谭谭的情难断	com.sqq.hy.music
从头开始播放冷漠的一路向北	com.sqq.hy.music
找找王峰的红唇	com.sqq.hy.music
我要听刘珂矣演唱的闲庭絮	com.sqq.hy.music
播唱柴三岁歌唱的坠入海底	com.sqq.hy.music
能不能给我播一下蒋雪儿的莫问归期	com.sqq.hy.music
宝宝现在想听杨小壮唱的两个世界	com.sqq.hy.music
立刻给我听一下乔艳艳的歌	com.sqq.hy.music
给我播一下崔子格	com.sqq.hy.music
从头开始给我播王靖雯不胖的歌	com.sqq.hy.music
给宝宝听许嵩的放肆	com.sqq.hy.music
开始播放祁隆的歌	com.sqq.hy.music
开始播放阿爸阿妈	com.sqq.hy.music
重新放一遍半吨兄弟的乘风破浪向你飘	com.sqq.hy.music
赵雷成都从头播放	com.sqq.hy.music
宋冬野安和桥放一下	com.sqq.hy.music
梅朵的下辈子不一定遇见播放一下	com.sqq.hy.music
演唱一首刀郎的歌	com.sqq.hy.music
播放李执鹏的海底	com.sqq.hy.music
马上播放韩红的歌	com.sqq.hy.music
马上播放九儿	com.sqq.hy.music
金志文的远走高飞给我播来听一下	com.sqq.hy.music
能给我播放任妙音红枣树吗	com.sqq.hy.music
我要听一下王琪的送亲	com.sqq.hy.music
现在想听邓泽鸣我要的自由	com.sqq.hy.music
推荐小曼的我这一生	com.sqq.hy.music
给我放王路演绎的情相依爱相守	com.sqq.hy.music
播一个刘大壮的信仰	com.sqq.hy.music
开始放杨小壮的一个人挺好	com.sqq.hy.music
我想来一个傅如乔的微微	com.sqq.hy.music
很喜欢周深的亲爱的旅人啊请循环播放	com.sqq.hy.music
播放一下韩红的九儿	com.sqq.hy.music
我想回顾校园金曲明天你好	com.sqq.hy.music
立刻播放半吨兄弟的飞蛾扑火	com.sqq.hy.music
我要播放学生时期火遍校园的素颜	com.sqq.hy.music
播放一下创造101里的红色高跟鞋	com.sqq.hy.music
立马播放小阿七的酒家	com.sqq.hy.music
老男孩电视剧原声带的牧马城市重播	com.sqq.hy.music
抖音神曲学猫叫从头开始播放	com.sqq.hy.music
我想再听一遍好好加油鸭	com.sqq.hy.music
我想再听一遍优秀少年的歌	com.sqq.hy.music
推荐一下华语热歌十年	com.sqq.hy.music
推荐一下陈奕迅的十年	com.sqq.hy.music
播放一下梦然的少年	com.sqq.hy.music
播放一下少年	com.sqq.hy.music
播放泰山乐队的歌	com.sqq.hy.music
播放一下坂本龍一的歌	com.sqq.hy.music
播放岩石乐队的歌	com.sqq.hy.music
播放一下三维鱼乐队的歌	com.sqq.hy.music
播放发条卡目索乐队的歌	com.sqq.hy.music
播放一下弥藏乐队的歌	com.sqq.hy.music
播放民谣风的歌	com.sqq.hy.music
播放一下泰兴黄桥合唱团的歌	com.sqq.hy.music
播放泰兴农业系统合唱团的歌	com.sqq.hy.music
播放一下安源红土地艺术团的歌	com.sqq.hy.music
播放红四军合唱团的歌	com.sqq.hy.music
播放一下西安群众合唱团的歌	com.sqq.hy.music
播放复原军人合唱团的歌	com.sqq.hy.music
播放一下景宁群众合唱团的歌	com.sqq.hy.music
播放青川县川北锣鼓艺术团的歌	com.sqq.hy.music
播放一下云南公安英模合唱团的歌	com.sqq.hy.music
播放加所中年男歌队的歌	com.sqq.hy.music
播放一下榕江县文工团的歌	com.sqq.hy.music
播放苗兰男女混声歌队的歌	com.sqq.hy.music
播放一下苗兰男歌队的歌	com.sqq.hy.music
播放苗兰女歌队的歌	com.sqq.hy.music
播放一下丰登男歌队的歌	com.sqq.hy.music
播放上海彩虹室内合唱团的歌	com.sqq.hy.music
播放一下黄家驹的歌	com.sqq.hy.music
播放宾阳乐队的歌	com.sqq.hy.music
播放一下mc光哥的歌	com.sqq.hy.music
开始播放mc光哥的歌	com.sqq.hy.music
播放BABOO乐团的歌	com.sqq.hy.music
开始播放baboo乐团的歌	com.sqq.hy.music
播放一下小公举的歌	com.sqq.hy.music
开始播放周杰伦的歌	com.sqq.hy.music
播放陈医生的歌	com.sqq.hy.music
开始播放陈奕迅的歌	com.sqq.hy.music
播放一下tfboys的歌	com.sqq.hy.music
开始播放tfboys的歌	com.sqq.hy.music
播放黄丽玲的歌	com.sqq.hy.music
开始播放a lin的歌	com.sqq.hy.music
播放一下刘天王的歌	com.sqq.hy.music
开始播放刘德华的歌	com.sqq.hy.music
播放动力火车的歌	com.sqq.hy.music
播放一下Tfboys的歌	com.sqq.hy.music
播放gem邓紫棋的歌	com.sqq.hy.music
开始播放邓紫棋的歌	com.sqq.hy.music
播放一下GEM邓紫棋的歌	com.sqq.hy.music
开始播放邓紫棋的歌	com.sqq.hy.music
播放梁博的歌	com.sqq.hy.music
播放一下beyond的歌	com.sqq.hy.music
开始播放Beyond的歌	com.sqq.hy.music
播放Beyond的歌	com.sqq.hy.music
播放一下火箭少女101的歌	com.sqq.hy.music
播放火箭少女幺零幺的歌	com.sqq.hy.music
开始播放火箭少女101的歌	com.sqq.hy.music
播放一下火箭少女一零一的歌	com.sqq.hy.music
开始播放火箭少女101的歌	com.sqq.hy.music
播放乐华七子的歌	com.sqq.hy.music
播放一下陈粒的歌	com.sqq.hy.music
播放s h e的歌	com.sqq.hy.music
开始播放S H E的歌	com.sqq.hy.music
播放一下王闪火的歌	com.sqq.hy.music
开始播放王以太的歌	com.sqq.hy.music
播放闪火的歌	com.sqq.hy.music
开始播放王以太的歌	com.sqq.hy.music
播放一下李贰叁的歌	com.sqq.hy.music
播放毛不易的歌	com.sqq.hy.music
播放一下郑钧的歌	com.sqq.hy.music
播放创造幺零幺的歌	com.sqq.hy.music
开始播放创造101的歌	com.sqq.hy.music
播放一下t f boys的歌	com.sqq.hy.music
开始播放tfboys的歌	com.sqq.hy.music
播放邓紫棋的歌	com.sqq.hy.music
播放一下m c天佑的歌	com.sqq.hy.music
开始播放MC天佑的歌	com.sqq.hy.music
播放f4组合的歌	com.sqq.hy.music
开始播放F4组合的歌	com.sqq.hy.music
播放一下f 4组合的歌	com.sqq.hy.music
开始播放F4组合的歌	com.sqq.hy.music
播放F4组合的歌	com.sqq.hy.music
播放一下exo组合的歌	com.sqq.hy.music
开始播放EXO组合的歌	com.sqq.hy.music
播放bigbang的歌	com.sqq.hy.music
开始播放BIGBANG的歌	com.sqq.hy.music
播放一下b y二的歌	com.sqq.hy.music
开始播放BY2的歌	com.sqq.hy.music
播放b y two的歌	com.sqq.hy.music
开始播放BY2的歌	com.sqq.hy.music
播放一下TF家族组合的歌	com.sqq.hy.music
播放SNH四十八的歌	com.sqq.hy.music
开始播放SNH48的歌	com.sqq.hy.music
播放一下SNH四八的歌	com.sqq.hy.music
开始播放SNH48的歌	com.sqq.hy.music
播放M C Hot Dog的歌	com.sqq.hy.music
开始播放MC HotDog的歌	com.sqq.hy.music
播放一下Ella陈嘉桦的歌	com.sqq.hy.music
开始播放Ella的歌	com.sqq.hy.music
播放EXO组合的歌	com.sqq.hy.music
播放一下big bang的歌	com.sqq.hy.music
开始播放BIGBANG的歌	com.sqq.hy.music
播放BIGBANG的歌	com.sqq.hy.music
播放一下飞儿乐队的歌	com.sqq.hy.music
播放阿信五月天的歌	com.sqq.hy.music
开始播放阿信的歌	com.sqq.hy.music
播放一下阿信的歌	com.sqq.hy.music
播放花花华晨宇的歌	com.sqq.hy.music
开始播放华晨宇的歌	com.sqq.hy.music
播放一下祖儿的歌	com.sqq.hy.music
开始播放容祖儿的歌	com.sqq.hy.music
播放容祖儿的歌	com.sqq.hy.music
播放一下田喜碧的歌	com.sqq.hy.music
开始播放田馥甄的歌	com.sqq.hy.music
播放牛奶咖啡组合的歌	com.sqq.hy.music
开始播放牛奶咖啡的歌	com.sqq.hy.music
播放一下温小岚的歌	com.sqq.hy.music
播放歌神张学友的歌	com.sqq.hy.music
开始播放张学友的歌	com.sqq.hy.music
播放一下张学友的歌	com.sqq.hy.music
播放杰伦的歌	com.sqq.hy.music
开始播放周杰伦的歌	com.sqq.hy.music
播放一下杨颖的歌	com.sqq.hy.music
开始播放angelababy的歌	com.sqq.hy.music
播放angelababy的歌	com.sqq.hy.music
播放一下晨晨魏晨的歌	com.sqq.hy.music
开始播放魏晨的歌	com.sqq.hy.music
播放小太阳钟汉良的歌	com.sqq.hy.music
开始播放钟汉良的歌	com.sqq.hy.music
播放一下小哥费玉清的歌	com.sqq.hy.music
开始播放费玉清的歌	com.sqq.hy.music
播放宋胖子的歌	com.sqq.hy.music
开始播放宋冬野的歌	com.sqq.hy.music
播放一下学冬的歌	com.sqq.hy.music
开始播放陈学冬的歌	com.sqq.hy.music
播放陈学冬的歌	com.sqq.hy.music
播放一下哈林的歌	com.sqq.hy.music
开始播放庾澄庆的歌	com.sqq.hy.music
播放周董的歌	com.sqq.hy.music
开始播放周杰伦的歌	com.sqq.hy.music
播放一下南拳妈妈N Q M M的歌	com.sqq.hy.music
开始播放南拳妈妈NQMM的歌	com.sqq.hy.music
播放加油少年的歌	com.sqq.hy.music
开始播放TFBOYS的歌	com.sqq.hy.music
播放一下仔仔周渝民的歌	com.sqq.hy.music
开始播放周渝民的歌	com.sqq.hy.music
播放vivian徐若瑄的歌	com.sqq.hy.music
开始播放徐若瑄的歌	com.sqq.hy.music
播放一下TFBOYS电台的歌	com.sqq.hy.music
播放阿桑的歌	com.sqq.hy.music
播放一下陈立农的歌	com.sqq.hy.music
播放迈克尔杰克逊的歌	com.sqq.hy.music
开始播放Michael Jackson的歌	com.sqq.hy.music
播放一下迈克杰克逊的歌	com.sqq.hy.music
开始播放Michael Jackson的歌	com.sqq.hy.music
播放maksim的歌	com.sqq.hy.music
开始播放Maksim的歌	com.sqq.hy.music
播放一下maksim mrvica的歌	com.sqq.hy.music
开始播放Maksim Mrvica的歌	com.sqq.hy.music
播放马克西姆的歌	com.sqq.hy.music
开始播放Maksim的歌	com.sqq.hy.music
播放一下lady gaga的歌	com.sqq.hy.music
开始播放Lady Gaga的歌	com.sqq.hy.music
播放断眉的歌	com.sqq.hy.music
开始播放Charlie Puth的歌	com.sqq.hy.music
播放一下酵母的歌	com.sqq.hy.music
开始播放Avril Lavigne的歌	com.sqq.hy.music
播放贾碧波的歌	com.sqq.hy.music
开始播放Justin Bieber的歌	com.sqq.hy.music
播放一下justin bieber的歌	com.sqq.hy.music
开始播放Justin Bieber的歌	com.sqq.hy.music
播放贾斯汀比伯的歌	com.sqq.hy.music
开始播放Justin Bieber的歌	com.sqq.hy.music
播放一下比伯的歌	com.sqq.hy.music
开始播放Justin Bieber的歌	com.sqq.hy.music
播放康明苏的歌	com.sqq.hy.music
开始播放Lady Gaga的歌	com.sqq.hy.music
播放一下lady ga ga的歌	com.sqq.hy.music
开始播放Lady Gaga的歌	com.sqq.hy.music
播放麦奶奶的歌	com.sqq.hy.music
开始播放Madonna的歌	com.sqq.hy.music
播放一下傻脸娜的歌	com.sqq.hy.music
开始播放Selena Gomez的歌	com.sqq.hy.music
播放beyonce的歌	com.sqq.hy.music
开始播放Beyonce的歌	com.sqq.hy.music
播放一下段奥娟的歌	com.sqq.hy.music
播放抖音小助手的歌	com.sqq.hy.music
播放一下beyond乐队的歌	com.sqq.hy.music
开始播放beyond的歌	com.sqq.hy.music
播放john style的歌	com.sqq.hy.music
播放一下the beatles的歌	com.sqq.hy.music
播放黑鸭子的歌	com.sqq.hy.music
播放一下黑鸭子组合的歌	com.sqq.hy.music
播放黑鸭子乐队的歌	com.sqq.hy.music
开始播放黑鸭子的歌	com.sqq.hy.music
播放一下权志龙的歌	com.sqq.hy.music
播放贝多芬的歌	com.sqq.hy.music
播放一下谷文昌	com.sqq.hy.iptv
播放高途课堂小学四年级语文	com.sqq.hy.iptv
播放一下谁在撒谎第二季	com.sqq.hy.iptv
播放房东和我	com.sqq.hy.iptv
播放一下高途课堂小学二年级英语	com.sqq.hy.iptv
播放养育者	com.sqq.hy.iptv
播放一下高途课堂小学三年级数学	com.sqq.hy.iptv
播放鲸鱼外教培优36岁自然拼读课程	com.sqq.hy.iptv
播放一下高途课堂小学五年级数学	com.sqq.hy.iptv
播放暮光之城暮色	com.sqq.hy.iptv
播放一下高途课堂小学三年级语文	com.sqq.hy.iptv
播放意大利制造	com.sqq.hy.iptv
播放一下高途课堂小学一年级英语	com.sqq.hy.iptv
播放平凡说电影	com.sqq.hy.iptv
播放一下高途课堂小学五年级英语	com.sqq.hy.iptv
播放卧室电台	com.sqq.hy.iptv
播放一下哈莉奎茵第一季	com.sqq.hy.iptv
播放跟谁学小学语文小学古诗荐读与仿写	com.sqq.hy.iptv
播放一下高途课堂小学五年级语文	com.sqq.hy.iptv
播放高途课堂小学三年级英语	com.sqq.hy.iptv
播放一下超星星学园	com.sqq.hy.iptv
播放碌碌人生第十一季	com.sqq.hy.iptv
播放一下新相亲大会精编版	com.sqq.hy.iptv
播放你们懂hiphop吗	com.sqq.hy.iptv
播放一下二月二十九	com.sqq.hy.iptv
播放跟谁学小学国学精讲三十六计	com.sqq.hy.iptv
播放一下高途课堂小学二年级数学	com.sqq.hy.iptv
播放跟谁学小学英语46年级精品课	com.sqq.hy.iptv
播放一下高途课堂小学六年级英语	com.sqq.hy.iptv
播放女婿上门了	com.sqq.hy.iptv
播放一下青少儿篮球等级考试	com.sqq.hy.iptv
播放小学语文作文八大技巧	com.sqq.hy.iptv
播放一下小学语文小学古诗荐读与仿写	com.sqq.hy.iptv
播放小学国学精讲三十六计	com.sqq.hy.iptv
播放一下决战猩球一九三七	com.sqq.hy.iptv
开始播放决战猩球1973	com.sqq.hy.iptv
播放谁在撒谎二	com.sqq.hy.iptv
开始播放谁在撒谎第二季	com.sqq.hy.iptv
播放一下鲸鱼外教培优3至6岁自然拼读课程	com.sqq.hy.iptv
开始播放鲸鱼外教培优36岁自然拼读课程	com.sqq.hy.iptv
播放哈莉奎茵一	com.sqq.hy.iptv
开始播放哈莉奎茵第一季	com.sqq.hy.iptv
播放一下碌碌人生十一	com.sqq.hy.iptv
开始播放碌碌人生第十一季	com.sqq.hy.iptv
播放跟谁学小学英语4至6年级精品课	com.sqq.hy.iptv
开始播放跟谁学小学英语46年级精品课	com.sqq.hy.iptv
播放一下勇敢者的游戏二太空飞行棋	com.sqq.hy.iptv
开始播放勇敢者的游戏2太空飞行棋	com.sqq.hy.iptv
播放三百六十五逆转命运的一年	com.sqq.hy.iptv
开始播放365逆转命运的1年	com.sqq.hy.iptv
播放一下电影解说一	com.sqq.hy.iptv
开始播放电影解说第一季	com.sqq.hy.iptv
播放年轻无忌一	com.sqq.hy.iptv
开始播放年轻无忌第一季	com.sqq.hy.iptv
播放一下勇敢者的游戏二	com.sqq.hy.iptv
播放电影解说	com.sqq.hy.iptv
播放一下年轻无忌	com.sqq.hy.iptv
播放决战猩球	com.sqq.hy.iptv
播放一下哦我的皇帝陛下	com.sqq.hy.iptv
播放谁在撒谎	com.sqq.hy.iptv
播放一下碌碌人生	com.sqq.hy.iptv
播放三六五逆转命运的一年	com.sqq.hy.iptv
开始播放365逆转命运的1年	com.sqq.hy.iptv
播放一下能源核守护者	com.sqq.hy.iptv
开始播放开心超人联盟之能源核守护者	com.sqq.hy.iptv
播放鲸鱼外教培优三至六岁自然拼读课程	com.sqq.hy.iptv
开始播放鲸鱼外教培优36岁自然拼读课程	com.sqq.hy.iptv
播放一下跟谁学小学英语四至六年级精品课	com.sqq.hy.iptv
开始播放跟谁学小学英语46年级精品课	com.sqq.hy.iptv
播放太空飞行棋	com.sqq.hy.iptv
播放一下逆转命运的一年	com.sqq.hy.iptv
播放鲸鱼外教培优	com.sqq.hy.iptv
播放一下小学英语四至六年级精品课	com.sqq.hy.iptv
播放三至六岁自然拼读课程	com.sqq.hy.iptv
播放一下爱思不si	com.sqq.hy.iptv
播放原生之罪	com.sqq.hy.iptv
播放一下博瑞客机器人	com.sqq.hy.iptv
播放危险的她	com.sqq.hy.iptv
播放一下勇敢者游戏2再战巅峰普通话	com.sqq.hy.iptv
播放亲宝科普之新型冠状病毒	com.sqq.hy.iptv
播放一下盖布瑞案消逝的小生命第一季	com.sqq.hy.iptv
播放阿吉车队秀	com.sqq.hy.iptv
播放一下大学我来了	com.sqq.hy.iptv
播放外宿的霍莉	com.sqq.hy.iptv
播放一下泰勒汤姆林森青年危机	com.sqq.hy.iptv
播放爱情箱子	com.sqq.hy.iptv
播放一下汉字里的中国人	com.sqq.hy.iptv
播放少年频道	com.sqq.hy.iptv
播放一下明星假扮成新婚夫妇将自己的行礼搬来装扮起自己的新婚房	com.sqq.hy.iptv
播放无心法师3	com.sqq.hy.iptv
播放一下潘达米松	com.sqq.hy.iptv
播放歪果仁看什么	com.sqq.hy.iptv
播放一下dont let them in	com.sqq.hy.iptv
播放直播游戏	com.sqq.hy.iptv
播放一下经典搞笑小品	com.sqq.hy.iptv
播放火星特工讲故事	com.sqq.hy.iptv
播放一下无人知晓	com.sqq.hy.iptv
播放漠叔的纪录	com.sqq.hy.iptv
播放一下跨时代战书片段	com.sqq.hy.iptv
播放人类星球	com.sqq.hy.iptv
播放一下嘟当曼百科常识第3季	com.sqq.hy.iptv
播放今日影评特别节目在春天	com.sqq.hy.iptv
播放一下鲁保罗变装皇后秀第十二季	com.sqq.hy.iptv
播放安娜斯塔西娅	com.sqq.hy.iptv
播放一下shop class	com.sqq.hy.iptv
播放勇敢者游戏二再战巅峰普通话	com.sqq.hy.iptv
开始播放勇敢者游戏2再战巅峰普通话	com.sqq.hy.iptv
播放一下盖布瑞案消逝的小生命一	com.sqq.hy.iptv
开始播放盖布瑞案消逝的小生命第一季	com.sqq.hy.iptv
播放无心法师三	com.sqq.hy.iptv
开始播放无心法师3	com.sqq.hy.iptv
播放一下嘟当曼百科常识第三季	com.sqq.hy.iptv
开始播放嘟当曼百科常识第3季	com.sqq.hy.iptv
播放鲁保罗变装皇后秀十二	com.sqq.hy.iptv
开始播放鲁保罗变装皇后秀第十二季	com.sqq.hy.iptv
播放一下亲宝科普	com.sqq.hy.iptv
播放青年危机	com.sqq.hy.iptv
播放一下粉红猪小妹	com.sqq.hy.iptv
播放在春天	com.sqq.hy.iptv
播放一下新型冠状病毒	com.sqq.hy.iptv
播放盖布瑞案消逝的小生命	com.sqq.hy.iptv
播放一下大惊小怪秀	com.sqq.hy.iptv
播放无心法师	com.sqq.hy.iptv
播放一下嘟当曼百科常识	com.sqq.hy.iptv
播放鲁保罗变装皇后秀	com.sqq.hy.iptv
播放一下嘟当曼百科常识三	com.sqq.hy.iptv
开始播放嘟当曼百科常识第3季	com.sqq.hy.iptv
播放熊出没之原始时代	com.sqq.hy.iptv
播放一下知否知否应是绿肥红瘦横竖看	com.sqq.hy.iptv
播放麦克唐纳与多兹第一季	com.sqq.hy.iptv
播放一下痞子超神	com.sqq.hy.iptv
播放金刚旅神团	com.sqq.hy.iptv
播放一下潮玩情报站之展高迷你特工队	com.sqq.hy.iptv
播放今天的风儿甚是喧嚣	com.sqq.hy.iptv
播放一下以你为名的青春	com.sqq.hy.iptv
播放手可摘星辰	com.sqq.hy.iptv
播放一下人偶动画排球	com.sqq.hy.iptv
播放猩红山峰	com.sqq.hy.iptv
播放一下追逐急流	com.sqq.hy.iptv
播放超自然灵媒师美子	com.sqq.hy.iptv
播放一下大地情书	com.sqq.hy.iptv
播放case347	com.sqq.hy.iptv
播放一下林晨同学	com.sqq.hy.iptv
播放海戈	com.sqq.hy.iptv
播放一下超级飞侠画世界	com.sqq.hy.iptv
播放说唱王戴夫	com.sqq.hy.iptv
播放一下模糊的家庭	com.sqq.hy.iptv
播放西游记儿歌第2季	com.sqq.hy.iptv
播放一下纯情丫头休想逃第2季	com.sqq.hy.iptv
播放深夜电台1晨星与明月	com.sqq.hy.iptv
播放一下我们在黎明进入	com.sqq.hy.iptv
播放分钟科学	com.sqq.hy.iptv
播放一下你好丹尼尔	com.sqq.hy.iptv
播放巴黎地下墓穴	com.sqq.hy.iptv
播放一下嗨蓝朋友	com.sqq.hy.iptv
播放papi sitter	com.sqq.hy.iptv
播放一下帝陵西汉帝陵	com.sqq.hy.iptv
播放如何成为一位好妻子	com.sqq.hy.iptv
播放一下欢乐多彩泥第2季	com.sqq.hy.iptv
我要听流潋紫的小说	com.sqq.audiocontent
我要听陈佩斯经典的小品	com.sqq.audiocontent
播放一部小清新的小说	com.sqq.audiocontent
我现在想听赵本山的小品全集	com.sqq.audiocontent
我想听尼尔斯骑鹅历险记	com.sqq.audiocontent
播放一部治愈的小说	com.sqq.audiocontent
能不能来一首越剧西厢记	com.sqq.audiocontent
我想听高三化学	com.sqq.audiocontent
播周建龙演播的鬼吹灯后传	com.sqq.audiocontent
播放一下单田芳的水浒传	com.sqq.audiocontent
我要听小熊维尼的故事	com.sqq.audiocontent
给我放一下刘兰芳的混世魔王程孝金	com.sqq.audiocontent
我想听有声书超级探险家	com.sqq.audiocontent
我想听那本男主人公叫张无忌的小说	com.sqq.audiocontent
单田芳白眉大侠给我播一下	com.sqq.audiocontent
我想听地藏经解说	com.sqq.audiocontent
给我放一下刘兰芳杨家将全传	com.sqq.audiocontent
播放许君聪小品劝架	com.sqq.audiocontent
我要听温柔的法兰西	com.sqq.audiocontent
我要听相声压岁钱	com.sqq.audiocontent
能不能来一首越剧西厢记	com.sqq.audiocontent
播放三字经	com.sqq.audiocontent
我要听相声压岁钱	com.sqq.audiocontent
能不能给我讲段女声版狼来了的故事	com.sqq.audiocontent
播放刘关张桃园三结义	com.sqq.audiocontent
我想听商君书	com.sqq.audiocontent
播放毛毛虫历险记	com.sqq.audiocontent
我想听毛毛虫历险记	com.sqq.audiocontent
可以给我播放悬疑恐怖小说吗	com.sqq.audiocontent
讲一个胖胖猪的故事	com.sqq.audiocontent
我要听相声压岁钱	com.sqq.audiocontent
拔苗助长的故事	com.sqq.audiocontent
播放桃园三结义	com.sqq.audiocontent
播放世界经典童话风	com.sqq.audiocontent
我要听段誉与虚竹练北冥神功的小说	com.sqq.audiocontent
我想听毛毛虫历险记	com.sqq.audiocontent
我想听1001夜的睡着的人与醒着的人	com.sqq.audiocontent
我想听小品昨天今天明天	com.sqq.audiocontent
我要听相声压岁钱	com.sqq.audiocontent
有没有卖火柴的小女孩的故事	com.sqq.audiocontent
有没有京剧鱼肠剑给我播放一下	com.sqq.audiocontent
给咱放蔡明老师在2014年春晚演出的小品	com.sqq.audiocontent
我想听儿歌数鸭子	com.sqq.audiocontent
推荐一下金庸的武侠小说	com.sqq.audiocontent
播放一个与皇帝有关的小说	com.sqq.audiocontent
我要听相声德云一队	com.sqq.audiocontent
我想听伊索寓言	com.sqq.audiocontent
给放下发展心理学	com.sqq.audiocontent
给宝宝放彩虹糖	com.sqq.audiocontent
播放罗贯中的三国演义	com.sqq.audiocontent
1996年春晚黄宏演出的小品给我放一下	com.sqq.audiocontent
可以放一个评书封神演义吗	com.sqq.audiocontent
我想听1年级英语秋季互动课	com.sqq.audiocontent
播放罗贯中的三国演义第五十集	com.sqq.audiocontent
麻烦给我播放个英文的儿童故事	com.sqq.audiocontent
放女主角叫洛诗涵的小说	com.sqq.audiocontent
帮我放平凡不可贵	com.sqq.audiocontent
请播放赵本山老师在2008年春晚演出的小说	com.sqq.audiocontent
你可以我想听明朝那些事	com.sqq.audiocontent
我想听海的女儿第九集	com.sqq.audiocontent
听一听小说戏说三国	com.sqq.audiocontent
播放凯叔讲故事的西游记最后一章	com.sqq.audiocontent
我想听曹雪芹的红楼梦最新一集	com.sqq.audiocontent
继续播放西游记最后一章	com.sqq.audiocontent
我要听我的贴身男秘	com.sqq.audiocontent
请播放精彩片段延禧攻略	com.sqq.audiocontent
我想听曹雪芹的红楼梦最新一集	com.sqq.audiocontent
我想听可口可乐的生意经	com.sqq.audiocontent
我要听史记	com.sqq.audiocontent
我想听二年级数学秋季互动课	com.sqq.audiocontent
播放一下日本超模的秘密小说	com.sqq.audiocontent
播放简爱	com.sqq.audiocontent
我要听相声德云一队	com.sqq.audiocontent
我要听刘心武的红楼梦	com.sqq.audiocontent
播放精彩片段水浒传	com.sqq.audiocontent
我想听一年级语文秋季互动课	com.sqq.audiocontent
给我放一下西游记大闹天宫	com.sqq.audiocontent
想看尼尔斯骑鹅历险记最后一集	com.sqq.audiocontent
播放罗贯中的三国演义最新一集	com.sqq.audiocontent
继续播放红楼梦最开始的一集	com.sqq.audiocontent
我想听文化中国致我们正在消逝的文化印记	com.sqq.audiocontent
播放罗贯中的三国演义第五十集	com.sqq.audiocontent
快放一个赵本山老师	com.sqq.audiocontent
我要听诸葛亮骂王朗精彩片段	com.sqq.audiocontent
来一曲二人转大西厢	com.sqq.audiocontent
我要听一棵皂角树	com.sqq.audiocontent
给我讲讲夏朝历史	com.sqq.audiocontent
听八月长安的振华三部曲小说	com.sqq.audiocontent
我想听曹雪芹的红楼梦最新一集	com.sqq.audiocontent
我想听狼和七只小羊的故事	com.sqq.audiocontent
我要听初二语文	com.sqq.audiocontent
可以给我放下三六五夜睡前故事的爱心树吗	com.sqq.audiocontent
播放王妃要出墙第一集	com.sqq.audiocontent
我想听红楼梦	com.sqq.audiocontent
我想听尼尔斯骑鹅历险记	com.sqq.audiocontent
给我推荐一本鬼吹灯	com.sqq.audiocontent
我想听霸道老公宠萌妻	com.sqq.audiocontent
播放罗贯中的三国演义第五十集	com.sqq.audiocontent
继续播放红楼梦最开始的一集	com.sqq.audiocontent
播放三国演义最后一集	com.sqq.audiocontent
我要听我的贴身男秘	com.sqq.audiocontent
我想听水浒传	com.sqq.audiocontent
三国演义	com.sqq.audiocontent
播放红楼梦最开始的一章	com.sqq.audiocontent
我想听易中天品三国	com.sqq.audiocontent
播放尼尔斯骑鹅历险记最新一集	com.sqq.audiocontent
望蔡明老师在2014年春晚演出的小品	com.sqq.audiocontent
播放三国演义第一集	com.sqq.audiocontent
从红楼梦最初的一章播放	com.sqq.audiocontent
我想听诸葛亮骂王朗片段	com.sqq.audiocontent
我要听三国演义第十集	com.sqq.audiocontent
我要听开心茶馆压岁钱	com.sqq.audiocontent
放一下黄梅戏天仙配给我	com.sqq.audiocontent
我想听四书五经	com.sqq.audiocontent
播放异界逍遥天尊	com.sqq.audiocontent
我想听5年级英语秋季护农科	com.sqq.audiocontent
来一首京剧长坂坡	com.sqq.audiocontent
我要听三国演义第10集	com.sqq.audiocontent
我要听红楼梦	com.sqq.audiocontent
我想听唐家三少的斗罗大陆	com.sqq.audiocontent
我想听三国演义	com.sqq.audiocontent
我想听萧红散文集	com.sqq.audiocontent
听文学书邓小平时代	com.sqq.audiocontent
我要听小鸭子	com.sqq.audiocontent
我要听红楼梦	com.sqq.audiocontent
我想听啄木鸟要高飞	com.sqq.audiocontent
播放水浒传	com.sqq.audiocontent
播放水浒传最后一集	com.sqq.audiocontent
放一曲花鼓戏双送粮	com.sqq.audiocontent
我要听罗贯中的小说	com.sqq.audiocontent
我要听罗贯中的小说	com.sqq.audiocontent
播放盗墓笔记不速之客	com.sqq.audiocontent
我要听京剧选段卖水	com.sqq.audiocontent
给我放一下三国演义刘备桃园三结义	com.sqq.audiocontent
我要听刘关张桃园三结义	com.sqq.audiocontent
给我放个西游记之真假美猴王	com.sqq.audiocontent
我要听三国演义曹孟德疑心杀亲友	com.sqq.audiocontent
我想听曹孟德疑心杀亲友	com.sqq.audiocontent
我要听评书刘关张桃园三结义	com.sqq.audiocontent
我要听刘关张桃园三结义	com.sqq.audiocontent
播放温酒斩华雄精彩片段	com.sqq.audiocontent
可以给我播放悬疑恐怖小说吗	com.sqq.audiocontent
我想听戏曲	com.sqq.audiocontent
我要听小品	com.sqq.audiocontent
我要听相声	com.sqq.audiocontent
我要听小说	com.sqq.audiocontent
我想听小说	com.sqq.audiocontent
帮我放一段喜剧	com.sqq.audiocontent
小说	com.sqq.audiocontent
想听戏曲	com.sqq.audiocontent
来一首唐诗	com.sqq.audiocontent
推理小说	com.sqq.audiocontent
我想听寓言散文	com.sqq.audiocontent
我想听恐怖小说	com.sqq.audiocontent
我要听历史军事小说	com.sqq.audiocontent
我想听儿童故事	com.sqq.audiocontent
麻烦给我播放个英文的儿童故事	com.sqq.audiocontent
播放一个民间故事	com.sqq.audiocontent
我想听课文	com.sqq.audiocontent
现在放一段秦腔	com.sqq.audiocontent
古希腊神话故事让我来听听看吧	com.sqq.audiocontent
打开贝瓦儿歌	com.sqq.audiocontent
打开口袋故事	com.sqq.audiocontent
打开义方教育	com.sqq.audiocontent
打开咪咕灵犀	com.sqq.audiocontent
打开六一儿童	com.sqq.audiocontent
打开汇智通	com.sqq.audiocontent
打开12星座	com.sqq.audiocontent
打开全通教育	com.sqq.audiocontent
打开喜马拉雅	com.sqq.audiocontent
打开贝乐虎	com.sqq.audiocontent
打开学而思	com.sqq.audiocontent
打开金榜题名	com.sqq.audiocontent
打开新华云	com.sqq.audiocontent
打开年糕妈妈	com.sqq.audiocontent
打开西地传媒	com.sqq.audiocontent
这是第几章	com.sqq.audiocontent
现在播放的是什么章节	com.sqq.audiocontent
现在播放的是什么书	com.sqq.audiocontent
收藏这本书	com.sqq.audiocontent
订阅书籍	com.sqq.audiocontent
请帮我收藏这本书	com.sqq.audiocontent
收藏书籍	com.sqq.audiocontent
取消订阅这本书	com.sqq.audiocontent
播放我收藏的听书	com.sqq.audiocontent
播放我收藏的书	com.sqq.audiocontent
给我播放订阅的故事	com.sqq.audiocontent
我想听收藏的书	com.sqq.audiocontent
看我收藏的书	com.sqq.audiocontent
播放我的听书收藏	com.sqq.audiocontent
播放我是不是你最疼爱的人	com.sqq.hy.music
播放一下爱得很寂寞	com.sqq.hy.music
播放人鱼公主	com.sqq.hy.music
播放一下风的低吟	com.sqq.hy.music
播放十八more	com.sqq.hy.music
播放一下青城山下白素贞	com.sqq.hy.music
播放写给荒海	com.sqq.hy.music
播放一下花田错	com.sqq.hy.music
播放aiyanga谁能了解我的心	com.sqq.hy.music
播放一下猎狐行动	com.sqq.hy.music
播放知心爱人	com.sqq.hy.music
播放一下爱的供养	com.sqq.hy.music
播放庭院深深	com.sqq.hy.music
播放一下浪里白条	com.sqq.hy.music
播放merci dieu merci	com.sqq.hy.music
播放一下默许之地	com.sqq.hy.music
播放人生没有保固期	com.sqq.hy.music
播放一下love around us 爱在身旁	com.sqq.hy.music
播放房间里不再下起雨	com.sqq.hy.music
播放一下依兰爱情故事	com.sqq.hy.music
播放愁深几许	com.sqq.hy.music
播放一下路过春秋	com.sqq.hy.music
播放以眼还眼	com.sqq.hy.music
播放一下mississipi	com.sqq.hy.music
播放沈园外	com.sqq.hy.music
播放一下霞客行	com.sqq.hy.music
播放声声念	com.sqq.hy.music
播放一下衣柜里有东西	com.sqq.hy.music
播放宿命	com.sqq.hy.music
播放一下中间	com.sqq.hy.music
播放打是疼你骂是爱	com.sqq.hy.music
播放一下exit星期七	com.sqq.hy.music
播放野百合也有春天	com.sqq.hy.music
播放一下写给自己的歌	com.sqq.hy.music
播放摇啊摇摇到外婆家	com.sqq.hy.music
播放一下粉红色的回忆	com.sqq.hy.music
播放后天	com.sqq.hy.music
播放一下花开在眼前	com.sqq.hy.music
播放城市之光	com.sqq.hy.music
播放一下禅外	com.sqq.hy.music
播放思念是一种病	com.sqq.hy.music
播放一下长春花	com.sqq.hy.music
播放一等轶闻	com.sqq.hy.music
播放一下喝那么多酒干嘛	com.sqq.hy.music
播放如果你也启程前往远方	com.sqq.hy.music
播放一下云水谣	com.sqq.hy.music
播放洁柔	com.sqq.hy.music
播放一下衣服裤子蝴蝶结	com.sqq.hy.music
播放可邻的爸爸妈妈	com.sqq.hy.music
播放一下hello mama	com.sqq.hy.music
播放rainy day	com.sqq.hy.music
播放一下恋爱达人秀	com.sqq.hy.music
播放双星记	com.sqq.hy.music
播放一下千禧恋曲	com.sqq.hy.music
播放dream is beautiful	com.sqq.hy.music
播放一下不落的音符(beauz remix)	com.sqq.hy.music
播放你我大团圆	com.sqq.hy.music
播放一下卡芭瑞	com.sqq.hy.music
播放梦千遍	com.sqq.hy.music
播放一下旋转浪漫	com.sqq.hy.music
播放弹词选曲珍珠塔二见姑	com.sqq.hy.music
播放一下这里会长出一朵花	com.sqq.hy.music
播放默默的相思	com.sqq.hy.music
播放一下传说	com.sqq.hy.music
播放外滩十八号	com.sqq.hy.music
播放一下红鬃烈马大登殿	com.sqq.hy.music
播放夏花如梦	com.sqq.hy.music
播放一下今生兄弟	com.sqq.hy.music
播放沙滩	com.sqq.hy.music
播放一下雨落屋檐易相思	com.sqq.hy.music
播放广东乐坛三部曲	com.sqq.hy.music
播放一下一切为了爱	com.sqq.hy.music
播放my boy	com.sqq.hy.music
播放一下风过耳边	com.sqq.hy.music
播放跟你走天涯	com.sqq.hy.music
播放一下雨水	com.sqq.hy.music
需要请再放一次玩具大陆了啊	com.sqq.hy.iptv
想重头再放平民英雄了呀	com.sqq.hy.iptv
现在想要从头放老广的味道ok吗	com.sqq.hy.iptv
还要从头播彩色世界童话了啊	com.sqq.hy.iptv
现在想再重放少年的你ok吗	com.sqq.hy.iptv
想要从头开始回家吃饭2020了	com.sqq.hy.iptv
想从头放一万年以后了	com.sqq.hy.iptv
现在想要重头再放龙珠Z了	com.sqq.hy.iptv
现在想要从头放一遍灌篮高手了	com.sqq.hy.iptv
希望从头播沐浴之王了呀	com.sqq.hy.iptv
想从头放自然传奇2020么	com.sqq.hy.iptv
想再放下我爱记歌词ok吗	com.sqq.hy.iptv
现在想要再放一遍秘境之眼2019了	com.sqq.hy.iptv
现在要从头再放一次木筏求生之寻找人类的新家园探险家辉哥么	com.sqq.hy.iptv
现在要再播放一遍吧万界神主了吗	com.sqq.hy.iptv
想要看一下体育新闻精彩看点2020了	com.sqq.hy.iptv
想要给我再放一次消费主张2019了吗	com.sqq.hy.iptv
现在要再播放一遍吧HBkids英语故事儿歌么	com.sqq.hy.iptv
现在想要重头再放棒棒趣味英语了	com.sqq.hy.iptv
要请再放一次飞儿我的世界模组我的世界么	com.sqq.hy.iptv
现在要再放一遍小偷家族ok吗	com.sqq.hy.iptv
要再放一遍大使高端教学明日之后么	com.sqq.hy.iptv
想要从头再放一次龙珠Z了吗	com.sqq.hy.iptv
现在想从头放一遍高能少年团了吗	com.sqq.hy.iptv
希望再放一遍部亿唐剧场三国演义	com.sqq.hy.iptv
想要从头放一遍一部笑声传奇	com.sqq.hy.iptv
现在想再放一遍一部三分练、七分吃炫舞健康小知识	com.sqq.hy.iptv
现在想给我再放一次部大黄蜂	com.sqq.hy.iptv
现在想再重放一下饮茶之功夫学园	com.sqq.hy.iptv
希望从头开始部舞蹈课堂	com.sqq.hy.iptv
要给我再放一次一部秦时明月	com.sqq.hy.iptv
要再放一部一禅小和尚	com.sqq.hy.iptv
现在要给我再放一次一下魔哒爆笑游戏解说	com.sqq.hy.iptv
想再放一次部幽灵毒枭	com.sqq.hy.iptv
想再播放一遍吧个一日一书	com.sqq.hy.iptv
现在想给我再放一次一个高中政治必修4第2单元	com.sqq.hy.iptv
要请再放一次一个英语口语坚持学习1000天	com.sqq.hy.iptv
还要再放一部贝尔小浪荒岛求生	com.sqq.hy.iptv
麻烦给我从头开始播放武林外传	com.sqq.hy.iptv
播个翻拍金庸剧典范天龙八部	com.sqq.hy.iptv
随机播个古宅恐怖游戏	com.sqq.hy.iptv
我想了解下传奇狙击手的故事	com.sqq.hy.iptv
我想了解下最惨烈的太平洋海战	com.sqq.hy.iptv
看一看盘点古代十大清官故事的廉吏传	com.sqq.hy.iptv
好莱坞式警匪片线人马上给我播下	com.sqq.hy.iptv
弄一个密战给我看	com.sqq.hy.iptv
可不可以给我播放超人前传氪星	com.sqq.hy.iptv
给朋友播放下毒枭墨西哥	com.sqq.hy.iptv
打开新华云	com.sqq.audiocontent
打开年糕妈妈	com.sqq.audiocontent
打开西地传媒	com.sqq.audiocontent
这是第几章	com.sqq.audiocontent
现在播放的是什么章节	com.sqq.audiocontent
现在播放的是什么书	com.sqq.audiocontent
收藏这本书	com.sqq.audiocontent
订阅书籍	com.sqq.audiocontent
请帮我收藏这本书	com.sqq.audiocontent
收藏书籍	com.sqq.audiocontent
取消订阅这本书	com.sqq.audiocontent
播放我收藏的听书	com.sqq.audiocontent
播放我收藏的书	com.sqq.audiocontent
给我播放订阅的故事	com.sqq.audiocontent
我想听收藏的书	com.sqq.audiocontent
看我收藏的书	com.sqq.audiocontent
播放我的听书收藏	com.sqq.audiocontent
播放最近听过的书	com.sqq.audiocontent
播放我最近听过的书	com.sqq.audiocontent
播放最近听过的故事	com.sqq.audiocontent
播放最近听过的一本书	com.sqq.audiocontent
播放最近听过的有声书	com.sqq.audiocontent
播放我听过的听书	com.sqq.audiocontent
放我听过的书	com.sqq.audiocontent
打开贝瓦儿歌的特别的日子	com.sqq.audiocontent
播放贝瓦儿歌的特别的日子	com.sqq.audiocontent
推荐一本书	com.sqq.audiocontent
最近有什么好听的	com.sqq.audiocontent
推荐一本专辑	com.sqq.audiocontent
我想听书	com.sqq.audiocontent
看个故事吧	com.sqq.audiocontent
我要听有声书	com.sqq.audiocontent
我要听书	com.sqq.audiocontent
播放听书	com.sqq.audiocontent
我想听故事	com.sqq.audiocontent
我要听有声书	com.sqq.audiocontent
播放听书	com.sqq.audiocontent
播放听书	com.sqq.audiocontent
我要听书	com.sqq.audiocontent
打开有声书	com.sqq.audiocontent
我要听有声书	com.sqq.audiocontent
来一本书	com.sqq.audiocontent
讲故事	com.sqq.audiocontent
我要听内容	com.sqq.audiocontent
想听书	com.sqq.audiocontent
给我讲个故事	com.sqq.audiocontent
听听书	com.sqq.audiocontent
给我讲个故事吧	com.sqq.audiocontent
播放温酒斩华雄精彩片段	com.sqq.audiocontent
可以给我播放悬疑恐怖小说吗	com.sqq.audiocontent
我想听戏曲	com.sqq.audiocontent
我要听小品	com.sqq.audiocontent
我要听相声	com.sqq.audiocontent
我要听小说	com.sqq.audiocontent
我想听小说	com.sqq.audiocontent
帮我放一段喜剧	com.sqq.audiocontent
小说	com.sqq.audiocontent
想听戏曲	com.sqq.audiocontent
可以放一个评书封神演义吗	com.sqq.audiocontent
我想听1年级英语秋季互动课	com.sqq.audiocontent
播放罗贯中的三国演义第五十集	com.sqq.audiocontent
麻烦给我播放个英文的儿童故事	com.sqq.audiocontent
放女主角叫洛诗涵的小说	com.sqq.audiocontent
帮我放平凡不可贵	com.sqq.audiocontent
请播放赵本山老师在2008年春晚演出的小说	com.sqq.audiocontent
你可以我想听明朝那些事	com.sqq.audiocontent
我想听海的女儿第九集	com.sqq.audiocontent
听一听小说戏说三国	com.sqq.audiocontent
播放凯叔讲故事的西游记最后一章	com.sqq.audiocontent
我想听曹雪芹的红楼梦最新一集	com.sqq.audiocontent
继续播放西游记最后一章	com.sqq.audiocontent
我要听我的贴身男秘	com.sqq.audiocontent
请播放精彩片段延禧攻略	com.sqq.audiocontent
我想听曹雪芹的红楼梦最新一集	com.sqq.audiocontent
我想听可口可乐的生意经	com.sqq.audiocontent
我要听史记	com.sqq.audiocontent
我想听二年级数学秋季互动课	com.sqq.audiocontent
播放一下日本超模的秘密小说	com.sqq.audiocontent
播放简爱	com.sqq.audiocontent
我要听相声德云一队	com.sqq.audiocontent
我要听刘心武的红楼梦	com.sqq.audiocontent
播放精彩片段水浒传	com.sqq.audiocontent
我想听一年级语文秋季互动课	com.sqq.audiocontent
给我放一下西游记大闹天宫	com.sqq.audiocontent
想看尼尔斯骑鹅历险记最后一集	com.sqq.audiocontent
播放罗贯中的三国演义最新一集	com.sqq.audiocontent
继续播放红楼梦最开始的一集	com.sqq.audiocontent
我想听文化中国致我们正在消逝的文化印记	com.sqq.audiocontent
播放罗贯中的三国演义第五十集	com.sqq.audiocontent
快放一个赵本山老师	com.sqq.audiocontent
我要听诸葛亮骂王朗精彩片段	com.sqq.audiocontent
来一曲二人转大西厢	com.sqq.audiocontent
我要听一棵皂角树	com.sqq.audiocontent
给我讲讲夏朝历史	com.sqq.audiocontent
听八月长安的振华三部曲小说	com.sqq.audiocontent
我想听曹雪芹的红楼梦最新一集	com.sqq.audiocontent
我想听狼和七只小羊的故事	com.sqq.audiocontent
我要听初二语文	com.sqq.audiocontent
可以给我放下三六五夜睡前故事的爱心树吗	com.sqq.audiocontent
播放王妃要出墙第一集	com.sqq.audiocontent
我想听红楼梦	com.sqq.audiocontent
我想听尼尔斯骑鹅历险记	com.sqq.audiocontent
给我推荐一本鬼吹灯	com.sqq.audiocontent
我想听霸道老公宠萌妻	com.sqq.audiocontent
播放罗贯中的三国演义第五十集	com.sqq.audiocontent
继续播放红楼梦最开始的一集	com.sqq.audiocontent
播放三国演义最后一集	com.sqq.audiocontent
我要听我的贴身男秘	com.sqq.audiocontent
我想听水浒传	com.sqq.audiocontent
三国演义	com.sqq.audiocontent
播放红楼梦最开始的一章	com.sqq.audiocontent
我想听易中天品三国	com.sqq.audiocontent
播放尼尔斯骑鹅历险记最新一集	com.sqq.audiocontent
望蔡明老师在2014年春晚演出的小品	com.sqq.audiocontent
播放三国演义第一集	com.sqq.audiocontent
从红楼梦最初的一章播放	com.sqq.audiocontent
我想听诸葛亮骂王朗片段	com.sqq.audiocontent
我要听三国演义第十集	com.sqq.audiocontent
我要听开心茶馆压岁钱	com.sqq.audiocontent
放一下黄梅戏天仙配给我	com.sqq.audiocontent
我想听四书五经	com.sqq.audiocontent
播放异界逍遥天尊	com.sqq.audiocontent
我想听5年级英语秋季护农科	com.sqq.audiocontent
来一首京剧长坂坡	com.sqq.audiocontent
我要听三国演义第10集	com.sqq.audiocontent
我要听红楼梦	com.sqq.audiocontent
我想听唐家三少的斗罗大陆	com.sqq.audiocontent
我想听三国演义	com.sqq.audiocontent
我想听萧红散文集	com.sqq.audiocontent
听文学书邓小平时代	com.sqq.audiocontent